QWWWWWW#WWWWWWE
A.....R.R.....D
A.....R.R.....D
ARRRRRR.RRRRRRD
#......;......#
ARRRRRR.RRRRRRD
A.....R.R.....D
A.....R.R.....D
ZXXXXXX#XXXXXXC