QWWWWWW#WWWWWWE
A^...........^D
A....+PPP+....D
A....PPPPP....D
#...PPP?PPP...#
A....PPPPP....D
A....+PPP+....D
A^...........^D
ZXXXXXX#XXXXXXC