QWWWWWW#WWWWWWE
ARR.........RRD
AR...........RD
A.....PPP.....D
#.....;;;.....#
A.....PPP.....D
AR...........RD
ARR.........RRD
ZXXXXXX#XXXXXXC