QWWWWWW#WWWWWWE
ARP.........PRD
AP...........PD
A......P......D
#.....PPP.....#
A......P......D
A.............D
A.............D
ZXXXXXX#XXXXXXC