QWWWWWW#WWWWWWE
A^^^^^^.^^^^^^D
A^+.........+^D
A^.....R.....^D
#.....RRR.....#
A^.....R.....^D
A^+.........+^D
A^^^^^^.^^^^^^D
ZXXXXXX#XXXXXXC