QWWWWWW#WWWWWWE
A;....R.R....;D
A..^.......^..D
A......P......D
#.....P;P.....#
A......P......D
A..^.......^..D
A;....R.R....;D
ZXXXXXX#XXXXXXC