QWWWWWW#WWWWWWE
A.............D
A.R.........R.D
A.............D
#.............#
A.............D
A.R.........R.D
A.............D
ZXXXXXX#XXXXXXC