QWWWWWW#WWWWWWE
APP.........PPD
AP+.........+PD
A......R......D
#.....+++.....#
A......R......D
AR...........RD
A^^^^^^.^^^^^^D
ZXXXXXX#XXXXXXC