QWWWWWW#WWWWWWE
A.............D
A...PPPPPPP...D
A.............D
#...?.........#
A.............D
A.............D
A.............D
ZXXXXXX#XXXXXXC