QWWWWWW#WWWWWWE
A.............D
A.............D
A.............D
#.............#
A.............D
A.............D
A.............D
ZXXXXXX#XXXXXXC