QWWWWWW#WWWWWWE
A.............D
A.........P...D
A.............D
#.........R...#
A.............D
A.............D
A.............D
ZXXXXXX#XXXXXXC