QWWWWWW#WWWWWWE
A?.^..........D
A.^...........D
A^............D
#......R......#
A.............D
A...........PPD
A...........P?D
ZXXXXXX#XXXXXXC